NO ./textures/thenry64.xpm
SO ./textures/colorstone.xpm
WE ./textures/redbrick.xpm
EA ./textures/wood.xpm

F 0,0,255
C 150,30,255

1111111
100N011
1000001
1000001
10f0001
1000001
1111111