NO ./textures/thenry64.xpm
SO ./textures/colorstone.xpm
WE ./textures/redbrick.xpm
EA ./textures/wood.xpm

F ,0,255
C 150,30,255

1111111
1000011
1000001
1N00001
1000001
1000001
1111111