NO ./textures/thenry64.xpm
SO ./textures/colorstone.xpm
WE ./textures/redbrick.xpm
EA  ./textures/bluestone.xpm

   F 1,111,1
   C 150,30,255


        111111111111111111111
        100000000011000000001
        101100N00111000000001
        100100000000000000001
11111111101100000111000000001
10000000001100000111011111111
11110111111111011100000000001
11110111111111011101010010001
11000000110101011100001110001
10000000000000000000010000001
10000000000000001101010010001
11000001110101011111011110001
11110111 1110101 111000000001
11111111 1111111 111111111111
11111111111111111111111111111
